いずみいおり	和泉一織	人名
にかいどうやまと	二階堂大和	人名
いずみみつき	和泉三月	人名
よつばたまき	四葉環	人名
おうさかそうご	逢坂壮五	人名
ろくやなぎ	六弥ナギ	人名
ななせりく	七瀬陸	人名
いずみ	和泉	人名
おうさか	逢坂	人名
ろくや	六弥	人名
ななせ	七瀬	人名
いおり	一織	人名
みつき	三月	人名
たまき	環	人名
そうご	壮五	人名
やおとめがく	八乙女楽	人名
くじょうてん	九条天	人名
つなしりゅうのすけ	十龍之介	人名
くじょう	九条	人名
つなし	十	人名
がく	楽	人名
りゅうのすけ	龍之介	人名
もも	百	人名
ゆき	千	人名
たかなしつむぎ	小鳥遊紡	人名
おおがみばんり	大神万里	人名
たかなしおとはる	小鳥遊音晴	人名
たかなし	小鳥遊	人名
おおがみ	大神	人名
つむぎ	紡	人名
ばんり	万里	人名
おとはる	音晴	人名
いすみはるか	亥清悠	人名
いぬまるとうま	狗丸トウマ	人名
なつめみなみ	棗巳波	人名
みどうとらお	御堂虎於	人名
いすみ	亥清	人名
いぬまる	狗丸	人名
なつめ	棗	人名
みどう	御堂	人名
はるか	悠	人名
みなみ	巳波	人名
とらお	虎於	人名
つくもりょう	月雲了	人名
つくも	月雲	人名
あいどりっしゅせぶん	IDOLiSH7	名詞
めっぞ	MEZZO"	名詞
とりがー	TRIGGER	名詞
りばーれ	Re:vale	名詞
ずーる	ZOOL	名詞
